+-+-+-+-+-+-+-+
|     |   |   |
+-+ +-+ +-+   +
|           | |
+      -+   +-+
| | |   | |   |
+-+ +-    +-+ +
|   |       | |
+-+-+-+-+-+-+-+